1111111.1111111111111111.1111111
1..............................1
1.1.1.1.1.11.1.11.1.11.1.1.1.1.1
1.1.$.1.1.1.....P....1.1.1.$.1.1
1.1.111.1.1.1.1111.1.1.1.111.1.1
1....1..1.1.1......1.1.1..1....1
1.11...11.1.1.1111.1.1.11...11.1
.....1.........$..........1.....
1111.1111.111.1GG1.111.1111.1111
1.......1.....1GG1.....1.......1
1.1.1.1.1.111.1GG1.111.1.1.1.1.1
1.1.1.........1GG1.........1.1.1
1..$..111.111.1SS1.111.111..$..1
11111.1.........$........1.11111
........1.1.111.1111.1.1........
1.11111.1.1...1..1...1.1.11111.1
1.1.$.1.1.111.11.1.111.1.1.$.1.1
1.1.1.1.......1..1.......1.1.1.1
1.1.1.1.11111.1.11.11111.1.1.1.1
1..............................1
1111111.1111111111111111.1111111
